11111111111111111111111111111
1P00000000C100001000000000001
1000000011C100001111111110001
10000001CCC100001CCCCCCC10001
1000001CC1C100001C11111C10001
100001CC11C100001E1011CC10001
10001CC111C1000011011CC110001
1001CC1111C100000011CC1100001
1001C11111C10000011CC11000001
1001CCCCCCC1000011CC110000001
1001111111C100011CC1100000001
1000000001C100011C11111110001
1000000001C000000CCCCCCC10001
11111111111111111111111111111
1M0M0M0M0M0M0M0M0M0M0M0M0M0M1
11111111111111111111111111111