111111111111111111111111111
1000000000001E1000000000001
100111M1M1M11C11M1M1M111001
1001MCCCCCCCCCCCCCCCCCM1001
1001111111111C1111111111001
11MCCCCCCCCCCCCCCCCCCCCCM11
1111111111111C1111111111111
1MMMMMMMMMMMMCMMMMMMMMMMMM1
1MMMMMMMMMMMMCMMMMMMMMMMMM1
1MMMMMMMMMMMMCMMMMMMMMMMMM1
1MMMMMMMMMMMMCMMMMMMMMMMMM1
1MMMMMMMMMMMMCMMMMMMMMMMMM1
1111111111111C1111111111111
1111111111111000000000000P1
111111111111111111111111111