111111111111111111111111111111
1C0M00C00010010000101000000101
1000000000001000011000C0000001
100101M000C0C00000000010000001
1001000010100010C00000000M0001
10001101M011000010000000000001
10C0000001C0001000000001M00001
100100000010M00000000100000001
100000000C00010M010001C0000001
1000000001000000011P00C0100001
101000000000C10000M01100000M11
100000000C000000000000M0010001
100000000010000C0000C000000011
10000011C100000000000M00000001
1000010010100C1C00M01000011001
1C0000M000000000100C0000110001
10000C0M0000000000100000100001
1000000000000001000000000M0001
1M000000M0000001100000C0000001
10C00000000000000C000000C00001
100000100000000000000000000001
10000M101M00000C100000000C0011
100100010000C01000000000101001
1000M0110000000010000000001101
1001000100000M0010000000001001
101000000000000001000M01010101
10011M000000000000100000000001
100000000E0000000000C0M10C0001
10M000000000000000000010001001
111111111111111111111111111111