1111111111
1M00001001
1E001C00M1
1111110011
1P00C0M101
1111111111