111111111111111
1111111E1111111
111111101111111
111111101111111
111111101111111
111111101111111
11111100M111111
111111101111111
111111000111111
111111101111111
111100000111111
111101101111111
111101CM0111111
111101111111111
111100M0C111111
111110001111111
1111110C0111111
111111101111111
1111111P1111111
111111111111111