1111111111
1001PEC101
1001111101
1111110011
1000000101
1111111111