11111111111111111111111111111111111111111111111111111111
1000000000000000000000000000000000000000000000000000PCE1
10000000000000000000000000000000000000000000000000000CC1
10000000000000000000000000000000000000000000000000000001
10000000000000000000000000000000000000000000000000000001
10000000000000000000000000000000000000000000000000000001
10000000000000000000000000000000000000000000000000000001
10000000000000000000000000000000000000000000000000000001
10000000000000000000000000000000000000000000000000000001
10000000000000000000000000000000000000000000000000000001
10000000000000000000000000000000010000000000000000000001
11111111111111111111111111111111111111111111111111111111