		  1111
		110CC011
		11000011
		11CCCC11
		11000011
		11000011
		11000011
	1111100000011111
   100000000000000001
   100P00001100000E001
    1111111  11111111