11111
1E001
10C01
1P0E1
11111