111111111
100000001
101110001
1P1C100E1
111111111