111111111
100000001
110000001
1P1C000E1
111111111