11111111111111111111111111111
11111111000001111111111111101
111111111000011111111111110E1
11111111P0000000C000000000001
11111111111111111111111111111