1111111
10000E1
100C001
1P00001
1111111